6 6
+ +-+-+-+-+-+
|   |       |
+-+ +-+-+-+ +
| |       | |
+ +-+-+-+ + +
|     | |   |
+ +-+ + +-+ +
| |       | |
+ +-+-+-+-+ +
|     |     |
+ +-+ + +-+-+
|   |       |
+-+-+-+-+-+ +
